14 20
-
0 0 0 0 0 0 0 8 0 0 0 0 0 0
0 0 0 0 0 0 0 1 0 3 3 0 0 0
0 0 0 0 0 1 1 1 0 3 0 0 0 3
0 0 0 0 0 1 0 0 0 0 0 0 0 0
3 0 0 0 0 1 0 0 0 0 0 9 0 0
3 0 0 0 0 1 1 1 0 0 0 0 0 0
0 0 0 0 0 0 0 1 1 0 0 0 0 0
0 0 0 0 0 0 0 0 1 1 0 0 0 0
0 3 0 0 0 0 0 0 0 1 0 0 0 0
0 0 0 9 0 5 0 0 0 1 0 0 0 0
0 0 0 0 0 0 3 0 0 1 0 0 0 0
0 0 0 0 0 2 0 0 0 1 1 0 0 0
3 3 0 0 2 2 0 0 0 0 1 0 0 0
3 3 3 0 0 0 0 0 0 0 1 0 0 0
3 0 0 1 1 1 1 1 1 1 1 0 0 0
0 0 0 1 0 0 0 0 0 0 0 0 0 0
0 2 0 1 1 0 0 0 0 5 0 0 0 0
0 0 0 0 1 0 0 0 0 0 0 2 0 0
0 0 0 3 1 1 1 1 0 0 0 2 0 0
0 0 0 0 0 0 0 7 0 0 0 0 0 0
-
0 0 0 0 0 0 0 8 0 0 0 0 0 0
0 0 0 0 0 0 0 1 1 1 0 0 0 0
0 0 0 0 0 0 0 0 3 1 0 0 0 3
0 0 3 0 0 0 0 0 3 1 0 0 0 0
3 3 3 0 0 0 0 0 3 1 0 0 0 0
0 3 3 0 0 0 2 0 1 1 0 0 0 0
0 0 0 0 0 0 0 1 1 0 0 0 0 0
0 0 0 0 0 0 0 1 0 0 0 0 0 0
0 3 0 0 0 0 0 1 0 0 0 0 0 0
0 1 1 1 1 1 1 1 0 0 0 0 0 0
0 1 9 0 5 0 3 0 0 0 3 3 0 0
0 1 0 0 0 0 0 0 0 0 3 3 3 0
0 1 0 2 2 0 0 0 0 3 3 3 3 0
0 1 1 0 2 2 0 0 3 3 3 3 0 0
0 0 1 1 1 0 0 0 0 0 3 0 0 0
0 0 3 0 1 0 0 0 0 0 0 0 0 0
0 3 3 0 1 0 0 0 0 0 0 5 0 0
0 3 0 0 1 1 1 1 0 0 0 0 0 0
0 0 0 0 0 0 0 1 0 0 0 0 0 0
0 0 0 0 0 0 0 7 0 0 0 0 0 0
-
0 0 0 0 0 0 0 8 0 0 0 0 0 0
0 0 0 0 0 0 0 1 0 0 3 0 0 0
0 0 0 0 0 0 0 1 0 0 0 0 0 3
0 0 0 0 0 0 0 1 0 0 0 2 0 0
3 0 0 0 0 0 0 1 0 0 0 2 0 0
3 0 2 2 0 0 0 1 0 0 0 0 0 0
0 0 0 0 0 0 0 1 0 0 0 0 9 0
0 0 0 0 0 0 0 1 1 0 0 0 0 0
0 3 0 0 0 0 0 0 1 1 0 0 0 0
0 0 0 0 0 0 0 0 0 1 0 0 0 0
0 0 5 0 0 0 3 3 0 1 3 0 0 0
0 0 0 0 0 3 3 3 0 1 1 0 3 0
0 3 0 0 0 3 3 3 0 5 1 0 0 0
0 3 3 0 3 3 3 3 0 1 1 0 0 0
0 0 0 0 0 1 1 1 1 1 0 0 0 0
0 0 9 1 1 1 0 0 0 0 3 0 0 0
0 0 0 1 0 0 0 0 0 0 3 3 3 0
0 0 0 1 0 1 1 1 0 0 0 3 3 0
0 0 0 1 1 1 0 1 0 0 0 0 0 0
0 0 0 0 0 0 0 7 0 0 0 0 0 0